29,22,
1,1,1,1,1,1,1,1,1,1,1,1,1,1,1,1,1,1,1,1,1,1,
1,1,1,1,1,1,1,1,1,1,1,1,1,1,0,0,0,0,0,0,0,0,0,0,0,0,1,4,4,
4,4,1,1,1,1,1,1,1,1,1,1,1,1,0,11,0,0,0,0,0,0,0,0,0,11,1,4,4,
4,4,1,1,1,1,1,1,1,1,1,1,1,1,0,0,0,0,1,1,1,1,1,0,0,0,0,4,4,
4,4,1,1,1,1,1,1,1,1,1,1,1,1,0,0,0,0,0,11,1,0,0,0,0,0,1,4,4,
4,4,1,0,0,1,1,1,1,1,1,1,1,1,0,0,0,0,0,0,1,0,0,0,0,0,1,4,4,
4,4,0,0,0,1,1,1,1,0,0,0,0,1,0,0,0,0,0,11,1,0,0,0,0,0,1,4,4,
4,4,1,0,0,1,1,1,1,0,0,11,0,1,0,0,0,0,0,0,1,0,0,0,0,0,1,4,4,
4,4,1,0,0,1,1,1,1,0,0,0,0,0,0,0,0,0,1,1,1,1,1,0,0,0,1,4,4,
4,4,1,0,0,1,1,1,1,0,0,0,0,1,0,0,0,0,0,0,0,0,0,0,0,11,0,4,4,
4,4,1,11,0,1,1,1,1,0,0,0,0,1,0,11,0,0,0,0,0,0,0,0,0,0,1,4,4,
4,4,1,0,0,1,1,1,1,0,0,0,0,1,0,0,0,0,0,0,0,0,1,1,0,1,1,1,1,
1,1,1,0,0,1,1,1,1,0,0,0,0,1,1,1,1,1,1,1,1,1,1,5,5,5,5,5,1,
6,6,6,6,6,6,1,1,1,0,0,0,0,1,2,2,2,2,2,2,2,2,1,5,5,5,5,5,1,
6,6,6,6,6,6,1,1,1,0,0,0,0,1,2,2,2,2,2,2,2,2,1,1,1,1,1,1,1,
6,6,6,6,6,6,1,1,1,1,0,1,1,1,2,2,3,3,3,3,2,2,7,7,7,7,7,7,7,
6,6,6,6,6,6,1,1,17,17,17,17,17,1,2,2,3,3,3,3,2,2,7,7,7,7,7,7,7,
6,6,6,6,6,6,1,1,17,17,17,17,17,1,2,2,3,3,3,3,2,2,1,1,1,1,1,1,1,
6,6,6,6,6,6,1,1,17,17,17,17,17,0,2,2,2,2,2,2,2,2,1,1,1,1,1,1,1,
6,6,6,6,6,6,1,1,17,17,17,17,17,1,2,2,2,2,2,2,2,2,1,1,1,1,1,1,1,
6,6,6,6,6,6,1,1,17,17,17,17,17,1,1,1,1,1,1,1,1,1,1,1,1,1,1,1,1,
1,1,1,1,1,1,1,1,1,1,1,1,1,1,1,1,1,1,1,1,1,1,1,1,1,1,1,1,1,
1,1,1,1,1,1,1,