57,30,
1,1,1,1,1,1,1,1,1,1,1,1,1,1,1,1,1,1,1,1,1,1,1,1,1,1,1,1,1,1,
1,1,1,1,1,1,1,1,1,1,1,1,1,1,1,1,1,1,1,1,1,1,1,1,1,1,1,1,17,17,17,17,17,17,17,1,0,0,1,0,0,0,0,0,0,0,0,0,0,0,0,0,0,0,0,0,0,
0,0,1,1,2,2,2,2,2,2,2,2,2,2,2,2,2,2,2,2,2,2,3,3,3,3,1,1,17,17,17,17,17,17,17,1,0,0,1,0,0,0,0,0,0,0,0,0,0,0,0,0,0,0,0,0,0,
0,0,1,2,2,2,2,2,2,2,2,2,2,2,2,2,2,2,2,2,2,3,3,3,3,3,1,1,17,17,17,17,17,17,17,1,0,0,1,0,0,0,0,12,0,0,0,0,12,0,0,0,0,0,0,0,0,
0,0,1,2,2,2,2,2,2,2,2,2,2,2,2,2,2,2,2,2,2,3,3,3,3,3,1,1,17,17,17,17,17,17,17,0,0,0,1,0,0,0,0,1,1,1,1,1,1,1,1,0,0,0,0,0,0,
0,0,2,2,2,2,2,2,2,2,2,2,2,2,2,2,2,2,2,2,3,3,3,3,3,3,1,1,17,17,17,17,17,17,17,1,1,1,1,0,0,0,0,1,0,0,0,0,0,0,1,0,0,0,0,0,0,
0,0,2,2,2,2,2,2,2,2,2,2,2,2,2,2,2,2,2,2,3,3,3,3,3,3,1,1,17,17,17,17,17,17,17,0,0,0,0,0,0,0,0,1,0,0,0,0,11,0,1,0,12,0,0,0,0,
0,0,1,2,2,2,2,2,2,2,2,2,2,2,2,2,2,2,2,2,3,3,3,3,3,3,1,1,17,17,17,17,17,17,17,0,0,0,0,0,0,0,0,0,0,0,0,0,0,0,0,0,0,0,0,0,0,
0,0,1,2,2,2,2,2,2,2,2,2,2,2,2,2,2,2,2,2,3,3,3,3,3,3,1,1,17,17,17,17,17,17,17,1,0,0,11,0,0,0,0,0,0,0,12,0,0,0,0,0,0,0,0,0,0,
0,0,1,1,2,2,2,2,2,2,2,2,2,2,2,2,2,2,2,2,3,3,3,3,3,3,1,1,17,17,17,17,17,17,17,1,11,0,0,0,0,0,0,1,0,0,0,0,11,0,1,0,0,0,0,0,0,
0,0,0,1,1,1,1,1,1,1,1,2,2,2,2,2,2,2,2,2,2,3,3,3,3,3,1,1,17,17,17,17,17,17,17,1,0,0,0,0,0,0,0,1,0,0,0,0,0,0,1,0,0,0,0,0,0,
0,0,0,0,1,3,3,3,3,3,1,2,2,2,2,2,2,2,2,2,2,3,3,3,3,3,1,1,17,17,17,17,17,17,17,1,0,0,0,0,0,0,0,1,1,1,1,1,1,1,1,0,0,0,0,0,0,
0,0,0,0,1,3,3,3,3,3,1,2,2,2,2,2,2,2,2,2,2,2,3,3,3,3,1,1,1,1,0,0,1,1,1,1,0,0,0,0,0,12,0,0,0,0,0,0,0,0,12,0,0,0,0,1,1,
1,0,1,1,1,3,3,3,3,3,1,1,1,1,1,1,1,1,1,1,1,1,1,1,1,1,1,1,0,0,0,0,0,0,0,1,0,0,0,0,0,0,0,0,0,0,0,0,0,0,0,0,0,0,0,1,0,
11,0,0,0,1,3,3,3,3,3,1,3,0,11,0,10,1,3,3,3,3,3,3,3,3,3,3,1,0,0,0,0,0,0,0,1,0,0,0,0,0,0,0,0,0,0,0,0,0,0,0,0,0,0,0,1,0,
0,0,0,0,0,3,3,3,3,3,3,3,0,0,0,10,1,3,3,3,3,3,3,3,3,3,3,1,0,0,0,0,0,0,0,1,1,1,1,1,1,1,1,1,1,1,1,1,1,1,1,1,1,1,1,1,0,
0,0,0,0,0,3,3,3,3,3,3,3,0,0,0,10,1,3,3,3,3,3,3,3,3,3,3,1,0,0,0,0,0,0,0,1,0,0,0,1,0,0,0,1,2,2,2,1,0,0,0,0,1,0,0,1,0,
0,0,11,0,1,3,3,3,3,3,1,3,0,11,0,10,1,3,3,3,3,3,3,3,3,3,3,1,1,1,1,1,1,0,1,1,0,12,0,1,0,11,0,1,2,2,2,1,0,0,0,0,1,0,0,1,1,
1,0,1,1,1,3,3,3,3,3,1,1,1,1,1,1,1,1,1,1,1,1,1,1,1,1,1,1,0,0,0,0,0,0,0,1,0,0,0,0,0,0,0,1,2,2,2,0,0,0,0,0,0,0,0,0,0,
0,0,0,0,1,3,3,3,3,3,1,2,2,2,2,2,2,2,2,2,2,2,3,3,3,3,1,1,0,0,0,0,0,0,0,1,0,0,0,0,0,0,0,1,2,2,2,0,0,0,0,0,0,0,0,0,0,
0,0,0,0,1,3,3,3,3,3,1,2,2,2,2,2,2,2,2,2,2,3,3,3,3,3,1,1,0,0,0,0,0,0,0,1,0,0,0,1,0,0,0,1,2,2,2,1,0,0,0,0,1,0,0,0,0,
0,0,0,1,1,1,1,1,1,1,1,2,2,2,2,2,2,2,2,2,2,3,3,3,3,3,1,1,0,0,0,0,0,0,0,1,0,0,0,1,0,0,0,1,2,2,2,1,0,0,0,0,1,0,0,0,0,
0,0,1,1,2,2,2,2,2,2,2,2,2,2,2,2,2,2,2,2,3,3,3,3,3,3,1,1,0,0,0,0,0,0,0,1,0,0,0,1,0,0,0,1,2,2,2,1,1,1,1,1,1,0,0,0,0,
0,0,1,2,2,2,2,2,2,2,2,2,2,2,2,2,2,2,2,2,3,3,3,3,3,3,1,1,0,0,0,0,0,0,0,1,0,0,0,1,0,0,0,1,2,2,2,1,0,0,0,0,0,0,0,0,0,
0,0,1,2,2,2,2,2,2,2,2,2,2,2,2,2,2,2,2,2,3,3,3,3,3,3,1,1,0,0,0,0,0,0,0,1,0,0,0,1,0,0,0,1,2,2,2,1,0,0,12,0,0,0,0,0,0,
0,0,2,2,2,2,2,2,2,2,2,2,2,2,2,2,2,2,2,2,3,3,3,3,3,3,1,1,0,0,0,0,0,0,0,0,0,0,0,1,0,0,0,0,2,2,2,1,0,0,0,0,0,0,0,0,0,
0,0,2,2,2,2,2,2,2,2,2,2,2,2,2,2,2,2,2,2,3,3,3,3,3,3,1,1,0,0,0,0,0,0,0,1,0,0,0,1,0,0,0,0,2,2,2,1,0,0,0,0,0,0,0,0,0,
0,0,1,2,2,2,2,2,2,2,2,2,2,2,2,2,2,2,2,2,2,3,3,3,3,3,1,1,0,0,0,0,0,0,0,1,0,12,0,1,0,12,0,1,2,2,2,1,0,0,12,0,0,0,0,0,0,
0,0,1,2,2,2,2,2,2,2,2,2,2,2,2,2,2,2,2,2,2,3,3,3,3,3,1,1,0,0,0,0,0,0,0,1,0,0,0,1,0,0,0,1,2,2,2,1,0,0,0,0,0,0,0,0,0,
0,0,1,1,2,2,2,2,2,2,2,2,2,2,2,2,2,2,2,2,2,2,3,3,3,3,1,1,1,1,1,1,1,1,1,1,1,1,1,1,1,1,1,1,1,1,1,1,1,1,1,1,1,1,1,1,1,
1,1,1,1,1,1,1,1,1,1,1,1,1,1,1,1,1,1,1,1,1,1,1,1,1,1,1,